1111111111111
1C00000000001
1000010001001
100P11E000001
1111111111111