111111111111111111111111111111
1C0100000000000000000000000001
1C01000E0000000000000000000001
1C0100000000000000000000000001
1C0100000000000000E00000000001
1C0100000000000000000000000001
100001111100100000000000000C01
100001111100100000000000000011
100001111100100000000000000011
100001111100100000000000000011
100001111100100000C00000000011
100001111100100000000000000011
100P11E00000100000000000000011
111111111111111111111111111111