11111111
10000001
1PCE0001
11111111
